####################
#                  #
#  #####    #####  #
#   ###      ###   #
#    #        #    #
#                  #
#                  #
#                  #
#    #        #    #
#   ###      ###   #
#  #####    #####  #
#                  #
####################