#########DD#########
#                  #
# ~~~~        ~~~~ #
# ~              ~ #
# ~              ~ #
# ~              ~ #
D ~ ~~~~~~~~~~~~ ~ D
# ~              ~ #
# ~              ~ #
# ~              ~ #
# ~~~~        ~~~~ #
#                  #
#########DD#########