#########DD#########
#                  #
#  ###        ###  #
#  ###        ###  #
#  ###        ###  #
#  ###        ###  #
D  ###        ###  D
#  ###        ###  #
#  ###        ###  #
#  ###        ###  #
#                  #
#                  #
#########DD#########