####################
#                  #
# ~~~~        ~~~~ #
# ~              ~ #
# ~              ~ #
# ~              ~ #
# ~ ~~~~~~~~~~~~ ~ #
# ~              ~ #
# ~              ~ #
# ~              ~ #
# ~~~~        ~~~~ #
#                  #
####################