#########DD#########
#                  #
# # # ##    ## # # #
#                  #
#                  #
#                  #
D # # ##    ## # # D
#                  #
#                  #
#                  #
# # # ##    ## # # #
#                  #
#########DD#########