#########DD#########
#                  #
#  ##############  #
#               #  #
#               #  #
#               #  #
D               #  D
#               #  #
#               #  #
#               #  #
#  ##############  #
#                  #
#########DD#########