#########DD#########
#                  #
#                  #
#                  #
#                  #
#                  #
D                  D
#                  #
#                  #
#                  #
#                  #
#                  #
#########DD#########