####################
#                  #
#  ###        ###  #
#  ###        ###  #
#  ###        ###  #
#  ###        ###  #
#  ###        ###  #
#  ###        ###  #
#  ###        ###  #
#  ###        ###  #
#                  #
#                  #
####################