#########DD#########
#                  #
#       #  #       #
#      #    #      #
#     #      #     #
#    #        #    #
D   #          #   D
#    #        #    #
#     #      #     #
#      #    #      #
#       #  #       #
#                  #
#########DD#########