####################
#                  #
#                  #
#  ##############  #
#  #            #  #
#  #            #  #
#  #            #  #
#  #            #  #
#  #            #  #
#  #####    #####  #
#                  #
#                  #
####################