####################
#                  #
# #              # #
# #              # #
# ##            ## #
#     #      #     #
#     ##     #     #
#     #      #     #
#        ##  #     #
#  ##    ##    ##  #
# ##            ## #
#                  #
####################