#########DD#########
#                  #
#                  #
#  ##############  #
#  #            #  #
#  #            #  #
D  #            #  D
#  #            #  #
#  #            #  #
#  #####    #####  #
#                  #
#                  #
#########DD#########