####################
#~~~~~~~~  ~~~~~~~~#
#~   ~~         ~ ~#
#~ ~ ~~    ~~~~ ~ ~#
#~ ~ ~~      ~~ ~ ~#
#~ ~ ~~      ~~ ~ ~#
#  ~ ~~~~  ~~~~ ~  #
#~ ~ ~~      ~~ ~ ~#
#~ ~ ~~      ~~ ~ ~#
#~ ~ ~~~~    ~~ ~ ~#
#~ ~         ~~   ~#
#~~~~~~~~  ~~~~~~~~#
####################