####################
#        ###########
#          #########
#            #######
#              #####
#                ###
#                  #
#                ###
#              #####
#            #######
#          #########
#        ###########
####################