#########DD#########
#~~~~~~~~  ~~~~~~~~#
#~   ~~         ~ ~#
#~ ~ ~~    ~~~~ ~ ~#
#~ ~ ~~      ~~ ~ ~#
#~ ~ ~~      ~~ ~ ~#
D  ~ ~~~~  ~~~~ ~  D
#~ ~ ~~      ~~ ~ ~#
#~ ~ ~~      ~~ ~ ~#
#~ ~ ~~~~    ~~ ~ ~#
#~ ~         ~~   ~#
#~~~~~~~~  ~~~~~~~~#
#########DD#########