#########DD#########
#                  #
#  #####    #####  #
#   ###      ###   #
#    #        #    #
#                  #
D                  D
#                  #
#    #        #    #
#   ###      ###   #
#  #####    #####  #
#                  #
#########DD#########