####################
#                  #
# # # ##    ## # # #
#                  #
#                  #
#                  #
# # # ##    ## # # #
#                  #
#                  #
#                  #
# # # ##    ## # # #
#                  #
####################