#########DD#########
#          #########
#          #########
#            #######
#              #####
#                ###
D                  D
#                ###
#              #####
#            #######
#          #########
#          #########
#########DD#########