#########DD#########
#                  #
# #              # #
# #              # #
# ##            ## #
#     #      #     #
D     ##     #     D
#     #      #     #
#        ##  #     #
#  ##    ##    ##  #
# ##            ## #
#                  #
#########DD#########