####################
#                  #
#                  #
#                  #
#                  #
#                  #
#   ############   #
#   ############   #
#   ############   #
#                  #
#                  #
#                  #
####################