####################
#                  #
#       #  #       #
#      #    #      #
#     #      #     #
#    #        #    #
#   #          #   #
#    #        #    #
#     #      #     #
#      #    #      #
#       #  #       #
#                  #
####################