#########DD#########
#                  #
#                  #
#                  #
#                  #
#                  #
D   ############   D
#   ############   #
#   ############   #
#                  #
#                  #
#                  #
#########DD#########