####################
#                  #
#  ##############  #
#               #  #
#               #  #
#               #  #
#               #  #
#               #  #
#               #  #
#               #  #
#  ##############  #
#                  #
####################