####################
#                  #
#                  #
#                  #
#                  #
#                  #
#                  #
#       #         #
#                 #
#                 #
#                  #
#                  #
####################